111111111111111111111111111111
1P0000000000000000000000000001
100000000000001111100000000001
100000000C00001111100000000001
100000000000001111100000000001
100011110000000000000000000001
100111111000000000000000000001
100000000000000011110000000001
100000000000C00111100000000001
1000000000000000000000000000E1
100000000000000000000000000001
100000111110000000000000000001
1C0000111110000000000000000001
100000000000000000000000000001
111111111111111111111111111111
